Abnormal uterine bleeding : Irregular, abnormally frequent, prolonged, or excessive amounts of uterine bleeding,
Abscess : Redness, pain, swelling,
Acquired Capillary Haemangioma of Eyelid : Raised red or blue lesion,
Acquired Immuno Deficiency Syndrome : Flu-like illness,
Acute encephalitis syndrome : Headache, fever, confusion, stiff neck, vomiting,
Adult Inclusion Conjunctivitis : Reddish eye, scratchiness,
Alcohol Abuse and Alcoholism : Drinking large amounts of alcohol over a long period, difficulty cutting down, acquiring and drinking alcohol taking up a lot of time, usage resulting in problems, withdrawal occurring when stopping,
Alopecia (hair loss) : Areas of hair loss, usually on the scalp,
Alzheimer : Memory loss, problems with language, disorientation, mood swings,
Amaurosis Fugax : Temporary fleeting of vision in one or both eyes,
Amblyopia : Decreased vision,
Amoebiasis : Bloody diarrhea, abdominal pain,
Anaemia : Feeling tired, pale skin, weakness, shortness of breath, feeling faint,
Aniseikonia : objects different sizes in each eye,
Anisometropia : Eyes' refractive power differs significantly,
Anthrax : small blister with surrounding swelling, fever, chest pain, shortness of breath, nausea, vomiting, diarrhea, abdominal pain, fever, abscess,
Anxiety : Worrying, fast heart rate, shakiness,
Appendicitis : Periumbilical or right lower abdominal pain, vomiting, decreased appetite,
Apraxia : Oral motor planning, speech delay,
Arthritis : Joint pain, stiffness, redness, swelling, decreased range of motion,
Asbestos-related diseases : Shortness of breath, cough, wheezing, chest pain,
Aseptic meningitis : Fever, headache, neck stiffness,
Asthma : Recurring episodes of wheezing, coughing, chest tightness, shortness of breath,
Astigmatism : Distorted or blurred vision at all distances, eyestrain, headaches,
Atherosclerosis : None,
Atrophy : Loss of body cells, signs of ageing,
Attention-Deficit Hyperactivity Disorder : Inattention, carelessness, hyperactivity, executive dysfunction, impulsivity,
Autism : Difficulties in social interaction, verbal and nonverbal communication, and the presence of repetitive behavior or restricted interests,
Bad Breath (Halitosis) : Unpleasant smell present on breath,
Bell's Palsy : Inability to move the facial muscles on one side, change in taste, pain around the ear,
Beriberi : Fast heart rate, shortness of breath, leg swelling,
Black Death : Fever, headaches, vomiting, swollen lymph nodes,
Bleeding Gums : Red, swollen, painful, bleeding gums, loose teeth, bad breath,
Blepharitis : crusty eyelids,
Blindness : Decreased ability to see,
Botulism : Weakness, trouble seeing, feeling tired, trouble speaking,
Brain Tumour : Vary depending on the part of the brain involved, headaches, seizures, problem with vision, vomiting, mental changes,
Breast Cancer / Carcinoma : A lump in a breast, a change in breast shape, dimpling of the skin, fluid from the nipple, a newly inverted nipple, a red scaly patch of skin on the breast,
Bronchitis : Coughing up mucus, wheezing, shortness of breath, chest discomfort,
Brucellosis : fever, chills, loss of appetite, sweats, weakness, fatigue, Joint, muscle and back pain, Headache,
Bunion : Prominent, red, and painful joint at the base of the big toe,
Burns : Red without blisters, Bone and tendon loss,
Calculi : Pain,
Campylobacter infection : Diarrhea, abdominal pain, fever,
Cancer : Lump, abnormal bleeding, prolonged cough, unexplained weight loss, change in bowel movements,
Candidiasis : White patches or vaginal discharge, itching,
Carbon monoxide poisoning : Headache, dizziness, weakness, vomiting, chest pain, confusion,
Carpal Tunnel Syndrome : Numbness, tingling in the thumb, index, middle finger, and half of ring finger,
Cavities : Pain, tooth loss, difficulty eating,
Celiacs disease : None or non-specific, abdominal distention, diarrhoea, constipation, malabsorption, weight loss, dermatitis herpetiformis,
Cerebral palsy : Poor coordination, Stiff or loose muscles, Weak muscles, Tremors,
Cervical cancer : none,
Chagas disease : Fever, large lymph nodes, headache,
Chalazion : Red, non painful cyst in middle of the eyelid,
Chickenpox : Small, itchy blisters, headache, loss of appetite, tiredness, fever,
Chikungunya Fever : Fever, joint pain,
Childhood Exotropia : Nonaligned eyes,
Chlamydia : None, vaginal discharge, discharge from the penis, burning with urination,
Cholera : Large amounts of watery diarrhea, vomiting, muscle cramps,
Chorea : Problems with motor skills, including coordination and gait, mood, and mental abilities,
Chronic fatigue syndrome : Worsening of symptoms with activity, long-term fatigue, others,
Chronic obstructive pulmonary disease (COPD) : Shortness of breath, chronic cough,
Cleft Lip and Cleft Palate : Opening in the upper lip that may extend into the nose or palate,
Colitis : Abdominal pain, diarrhea mixed with blood, weight loss, fever, anemia,,
Colorectal Cancer : Blood in stool, change in bowel movements, unintentional weight loss, vomiting, fatigue,
Common cold : Cough, sore throat, runny nose, fever,
Condyloma : Skin lesion that is generally pink in color and project outward,
Congenital anomalies (birth defects) : Physical disability, intellectual disability, developmental disability,
Congestive heart disease : Shortness of breath, exhaustion, swollen legs,
Corneal Abrasion : Eye pain, light sensitivity,
Coronary Heart Disease : Chest pain, shortness of breath,
Coronavirus disease 2019 (COVID-19) : Fever, cough, fatigue, shortness of breath, vomiting, loss of taste or smell, some cases asymptomatic,
Cough : Runny nose, fever, cough,
Cretinism : Goiter, mental impairment, poor growth, infertility, hair loss,
Crimean Congo haemorrhagic fever (CCHF) : Fever, muscle pains, headache, vomiting, diarrhea, bleeding into the skin,
Deafness : Decreased ability to hear,
Dehydration : Increased thirst, tiredness, decreased urine, dizziness, headaches, and confusion,
Dementia : Decreased ability to think and remember, emotional problems, problems with language, decreased motivation,
Dengue : Fever, headache, muscle and joint pain, rash,
Diabetes Mellitus : Frequent urination, Increased thirst, Increased hunger,
Diabetic Retinopathy : Often asymptomatic, but can cause spots in the eye and vision loss,
Diarrhea : Loose frequent bowel movements, dehydration,
Diphtheria : Sore throat, fever, barking cough,
Distichiasis : Eyelash, congenital heart defects and various vascular abnormalities,
Down's Syndrome : Delayed physical growth, characteristic facial features, mild to moderate intellectual disability,
Dracunculiasis (guinea-worm disease) : Painful blister that a long white string-like worm slowly crawls out of,
Dysentery : Bloody diarrhea, abdominal pain, fever,
Dyslexia and Ocular Features : Trouble reading,
Ear infection : Ear pain, fever, hearing loss,
Early pregnancy loss : Vaginal bleeding with or without pain,
Ebola : Fever, sore throat, muscular pain, headaches, diarrhoea, bleeding,
Eclampsia : Seizures, high blood pressure,
Ectopic pregnancy : Abdominal pain, vaginal bleeding,
Eczema : Itchiness, red skin, rash,
Endometriosis : Pelvic pain, infertility,
Epidemic Keratoconjunctivitis : Red eye, discomfort/irritation, sensitivity to light, watering, blurred vision, discharge,
Epilepsy : Periods of vigorous shaking, nearly undetectable spells,
Erectile dysfunctions : Inability to gain or maintain an erection,
Exposure Keratopathy : Dryness, irritation, redness, eye pain and photophobia,
Fibroids : Painful or heavy periods,
Fibromyalgia : Widespread pain, feeling tired, sleep problems,
Filamentary Keratitis : Eye pain, blurred vision, red eye, eye discharge, photophobia, corneal ulceration,
Filariasis : None, severe swelling of the arms, legs, breasts, or genitals,
Food Poisoning : Flushed skin, headache, itchiness, blurred vision, abdominal cramps, diarrhea,
Frey's Syndrome : Redness and sweating of cheek area when salivating,
Frost Bite : Numbness, feeling cold, clumsiness, pale color,
GERD : Taste of acid, heartburn, bad breath, chest pain, breathing problems,
Gaming disorder : Problem gambling,, depression, social withdrawal, playing video games for extremely long periods of time,
Gangrene : Change in skin color to red or black, numbness, pain, skin breakdown, coolness,
Gastroenteritis : Diarrhea, vomiting, abdominal pain, fever,
Genital herpes : None, small blisters that break open to form painful ulcers, flu-like symptoms,
Glaucoma : Vision loss, eye pain, mid-dilated pupil, redness of the eye, nausea,
Goitre : Goitre,
Gonorrhea : None, burning with urination, vaginal discharge, discharge from the penis, pelvic pain, testicular pain,
Guillain-Barr√© syndrome : Muscle weakness beginning in the feet and hands, usually ascending,
Haemophilia : Easy and prolonged bleeding,
Hand, Foot and Mouth Disease : Fever, flat discolored spots or bumps that may blister,
Heart disease : Chest pain, shortness of breath, fatigue, loss of consciousness,
Hepatitis : Yellowish skin, poor appetite, abdominal pain,
Hepatitis A : Nausea, vomiting, diarrhea, dark urine, jaundice, fever, abdominal pain,
Hepatitis B : None, yellowish skin, tiredness, dark urine, abdominal pain,
Hepatitis C : Typically none,
Hepatitis D : Feeling tired, nausea and vomiting,
Hepatitis E : Nausea, jaundice,
Herpes Simplex : Blisters that break open and form small ulcers, fever, swollen lymph nodes,
High risk pregnancy : Missed periods, tender breasts, nausea and vomiting, hunger, frequent urination,
Human papillomavirus : None, warts,
Hypermetropia : Near blur, Distance and near blur, Asthenopia,
Hyperthyroidism : Irritability, muscle weakness, sleeping problems, fast heartbeat, heat intolerance, diarrhea, enlargement of the thyroid, weight loss,
Hypothyroid : Poor ability to tolerate cold, feeling tired, constipation, weight gain,,
Hypotonia : Muscle weakness,
Ichthyosis : Very thick skin which cracks, abnormal facial features,
Impetigo : Yellowish skin crusts, painful,
Inflammatory Bowel Disease : Abdominal pain, diarrhea (may be bloody), fever, weight loss,,
Influenza : Fever, runny nose, sore throat, muscle pain, headache, coughing, fatigue,
Insomnia : Trouble sleeping, daytime sleepiness, low energy, irritability, depressed mood,
Interstitial cystitis : Chronic pain of the bladder, feeling the need to urinate right away, needing to urinate often, pain with sex,
Iritis : Headaches, red eyes, blurred vision, photophobia, burning and redness of the eye,
Iron Deficiency Anemia : Feeling tired, weakness, shortness of breath, confusion, pallor,
Irritable bowel syndrome : Diarrhea, constipation, abdominal pain,
Japanese Encephalitis : Headache, fever, vomiting, confusion, seizures,
Jaundice : Yellowish coloration of skin and sclera, itchiness,
Kala-azar/ Leishmaniasis : Skin ulcers, fever, low red blood cells, enlarged liver,
Kaposi‚Äôs Sarcoma : Purple colored skin lesions,
Keratoconjunctivitis Sicca (Dry eye syndrome) : Dry eyes, irritation, redness, discharge, blurred vision,
Keratoconus : Blurry vision, nearsightedness, light sensitivity,
Kidney stone disease : Severe pain in the lower back or abdomen, blood in the urine, vomiting, nausea,
Kuru : Body tremors, random outbursts of laughter, gradual loss of coordination,
Laryngitis : Hoarse voice, fever, pain,
Lead poisoning : Intellectual disability, abdominal pain, constipation, headaches, irritability, memory problems, inability to have children, tingling in the hands and feet,
Legionellosis : Cough, shortness of breath, fever, muscle pains, headaches,
Leprosy : Decreased ability to feel pain,
Leptospirosis : None, headaches, muscle pains, fevers,
Leukemia : Bleeding, bruising, fatigue, fever, increased risk of infections,
Lice : Itching that can result in trouble sleeping,
Listeriosis : Diarrhea, fever, headache,
Lung cancer : Coughing (including coughing up blood), shortness of breath, chest pain,
Lupus erythematosus : Painful and swollen joints, fever, chest pain, hair loss, mouth ulcers, swollen lymph nodes, feeling tired, red rash,
Lyme disease : Expanding area of redness at the site of a tick bite, fever, headache, tiredness,
Lymphoma : Enlarged lymph nodes, fever, sweats, unintended weight loss, itching, feeling tired,
Mad cow disease : Abnormal behavior, trouble walking, weight loss, inability to move,
Malaria : Fever, vomiting, headache, yellow skin,
Marburg fever : Fever, weakness, muscle pain,
Mastitis : Localized breast pain and redness, fever,
Measles : Fever, cough, runny nose, inflamed eyes, rash,
Melanoma : Mole that is increasing in size, has irregular edges, change in color, itchiness, or skin breakdown,
Microcephaly : Abnormally small head and brain, neurological impairments,
Middle East respiratory syndrome coronavirus (MERS‚ÄêCoV) : Fever, cough, shortness of breath,
Migraine : Headaches, nausea, sensitivity to light, sound, and smell,
Monkeypox : Fever, headache, muscle pains, shivering, blistering rash, swollen lymph nodes,
Mononucleosis : Fever, sore throat, enlarged lymph nodes in the neck, tiredness,
Mouth Breathing : Snoring, dry mouth, hoarse voice, bad breath, fatigue, sleep apnea,
Mouth Ulcers : A round, often painful sore inside the mouth that is white or gray with a red border, Tingling or burning sensation prior to sore development, Fever, sluggishness, and/or swollen lymph nodes (severe cases only),
Mucormycosis : Depends on location: runny nose, black area of skin, facial swelling, headache, fever, cough, blurred vision,
Multiple myeloma : Bone pain, fatigue, : 653
Multiple sclerosis : Variable, including almost any neurological symptom or sign, with autonomic, visual, motor, and sensory problems being the most common,
Mumps : Parotitis and non-specific symptoms such as fever, headache, malaise, muscle pain, and loss of appetite,
Muscular dystrophy : Increasing weakening, breakdown of skeletal muscles, trouble walking,
Myasthenia gravis : Varying degrees muscle weakness, double vision, drooping eyelids, trouble talking, trouble walking,
Myelitis : Weakness of the limbs,
Myocardial Infarction (Heart Attack) : Chest pain, shortness of breath, nausea, feeling faint, cold sweat, feeling tired, arm, neck, back, jaw, or stomach pain,
Myopia : Distant objects appear blurry, close objects appear normal, headaches, eye strain,
Myxedema : deterioration of the patient's mental status,
Narcolepsy : Excessive daytime sleepiness, involuntary sleep episodes, sudden loss of muscle strength, hallucinations,
Nasal Polyps : Trouble breathing through the nose, loss of smell, decreased taste, post nasal drip, runny nose,
Nausea and Vomiting of Pregnancy and Hyperemesis gravidarum : Nausea and vomiting such that weight loss and dehydration occur,
Necrotizing Fasciitis : Severe pain, fever, purple colored skin in the affected area,
Neoplasm : Lump,
Neuralgia : episodes of severe, sudden, shock-like pain in one side of the face that lasts for seconds to minutes,
Night blindness : Decreased ability to see colors,
Nipah virus infection : None, fever, cough, headache,diarrhea, confusion,
Nonalcoholic fatty liver disease(NAFLD) : Asymptomatic in the early stages, In later stages:, * Deposits of cholesterol on the eye lids, * Fatigue, * Crusty red nodules, * Digestive issues, Lastly causes liver dysfunction and eventually liver failure,
Obesity : Increased fat,
Obsessive Compulsive Disorder : Feel the need to check things repeatedly, perform certain routines repeatedly, have certain thoughts repeatedly,
Oral Cancer : Persistent rough white or red patch in the mouth lasting longer than 2 weeks, ulceration, lumps/bumps in the neck, pain, loose teeth, difficulty swallowing,
Orbital Haemangiopericytoma : Painless mass,
Orbital Varix : Internal bleeding,
Osteoarthritis : Joint pain, stiffness, joint swelling, decreased range of motion,
Osteomyelitis : Pain in a specific bone, overlying redness, fever, weakness,
Osteoporosis : Increased risk of a broken bone,
Paratyphoid fever : Fever, headache, rash, weakness,
Parkinson's Disease : Tremor, rigidity, slowness of movement, difficulty walking,
Pellucid Marginal Degeneration : Vision loss,
Pelvic inflammatory disease : Lower abdominal pain, vaginal discharge, fever, burning with urination, pain with sex, irregular menstruation,
Pericarditis : Sharp chest pain, better sitting up and worse with lying down, fever,
Peritonitis : Severe pain, swelling of the abdomen, fever,
Pharyngoconjunctival Fever : Upper respiratory: nasal congestion, coryza, cough, wheeze, fast breathing, General: fever, tiredness, chills, muscle aches, headache, tummy ache, tonsillitis, lymphadenopathy, Pharyngoconjunctival fever: pinky-red eyes, fever, sore throat, Keratoconjunctivitis: red painful eye, poor vision, intolerance to light, watery eyes, discharge, swelling of the conjunctiva, Gastroenteritis: diarrhoea, vomiting, tummy ache,, Urinary tract infection: Burning and increase frequency of passing urine,
Plague : Fever, weakness, headache,
Pneumonia : Cough, shortness of breath, chest pain, fever,
Poliomyelitis : Fever, sore throat,
Polycystic ovary syndrome (PCOS) : Irregular menstrual periods, heavy periods, excess hair, acne, pelvic pain, difficulty getting pregnant, patches of thick, darker, velvety skin,
Porphyria : Depending on subtype‚Äîabdominal pain, chest pain, vomiting, confusion, constipation, fever, seizures, blisters with sunlight,
Post-herpetic neuralgia : burning or stabbing pain, pain doesn't end after the shingles subsides,
Postpartum depression/ Perinatal depression : Extreme sadness, low energy, anxiety, changes in sleeping or eating patterns, crying episodes, irritability,
Postpartum haemorrhage : Significant blood loss after childbirth, increased heart rate, feeling faint upon standing, increased breath rate,
Preeclampsia : High blood pressure, protein in the urine,
Premenstrual syndrome : Fatigue, irritability and other mood changes, tender breasts, abdominal bloating,
Presbyopia : Difficulty reading small print, having to hold reading material farther away, headaches, eyestrain,
Preterm birth : Birth of a baby at younger than 37 weeks' gestational age,
Progeria : Growth delay, short height, small face, hair loss,
Psoriasis : Red (purple on darker skin), itchy, scaly patches of skin,
Pterygium : Pinkish, triangular tissue growth on the cornea,
Pubic lice : Itch, scratch marks, grey-blue marks, visible lice and nits,
Puerperal sepsis : Fever, lower abdominal pain, bad-smelling vaginal discharge,
Pulmonary embolism : Shortness of breath, chest pain, coughing up blood,
Quinsy : Fever, throat pain, trouble opening the mouth, change to the voice,
Rabies : Fever, fear of water, confusion, excessive salivary secretion, hallucinations, disrupted sleep, paralysis, coma,,
Raynaud's Phenomenon : An affected part turning white, then blue, then red, burning,
Repetitive strain injury : Sore wrists, aching, pulsing pain, tingling, extremity weakness,
Rheumatic fever : Fever, multiple painful joints, involuntary muscle movements, erythema marginatum,
Rheumatism : Warm, swollen, painful joints,
Rickets : Bowed legs, stunted growth, bone pain, large forehead, trouble sleeping,
Rift Valley fever : Fever, muscle pains, headaches,
Rocky Mountain spotted fever : Fever, headache,
Rubella : Rash, swollen lymph nodes, fever, sore throat, feeling tired,
SARS : Fever, persistent dry cough, headache, muscle pains, difficulty breathing,
Salmonellosis : Diarrhea, fever, abdominal cramps, vomiting,
Sarcoidosis : Depends on the organ involved,
Sarcoma : Swell and pain near the tumor,
Scabies : itchiness, pimple-like rash,
Scarlet fever : Sore throat, fever, headaches, swollen lymph nodes in the neck, characteristic rash,
Schizophrenia : Hallucinations (usually hearing voices), delusions, confused thinking,
Sciatica : Pain going down the leg from the lower back, weakness or numbness of the affected leg,
Scrapie : Dementia, seizures, tremors, insomnia, psychosis, delirium, confusion,
Scrub Typhus : Fever, headache, rash,
Scurvy : Weakness, feeling tired, changes to hair, sore arms and legs, gum disease, easy bleeding,
Sepsis : Fever, increased heart rate, low blood pressure, increased breathing rate, low urine output, absent or near absent urine output, severe pain, confusion,
Sexually transmitted infections (STIs) : None, vaginal discharge, penile discharge, ulcers on or around the genitals, pelvic pain,
Shaken Baby Syndrome : Variable,
Shigellosis : Diarrhea, fever, abdominal pain,
Shin splints : Pain along the inside edge of the shinbone,
Shingles : Painful rash,
Sickle-cell anemia : Attacks of pain, anemia, swelling in the hands and feet, bacterial infections, stroke,
Smallpox : mw-parser-output plainlist ol,mw-parser-output plainlist ul{line-height:inherit,list-style:none,margin:0,padding:0}mw-parser-output plainlist ol li,mw-parser-output plainlist ul li{margin-bottom:0}, Fever, vomiting, mouth sores, Fluid filled blisters which scab over,
Spinal cord Injury : Numbness, weakness, abnormal reflexes, loss of bladder or bowel control, neck pain,
Stevens-Johnson syndrome : Fever, skin blisters, skin peeling, painful skin, red eyes,
Stomach ulcers : Heartburn, upper abdominal pain, nausea, belching, vomiting, blood in the stool, weight loss, weight gain, bloating, loss of appetite, yellowing of the skin and whites of the eyes difficulty swallowing,
Strep throat : Fever, sore throat, enlarged lymph nodes,
Stroke : Inability to move or feel on one side of the body, problems understanding or speaking, dizziness, loss of vision to one side,
Sub-conjunctival Haemorrhage : Red spot over whites of the eye, little to no pain,
Substance abuse : Excessive use of drugs despite negative consequences,
Superior Limbic Keratoconjunctivitis : Eye redness, burning sensation, tearing,
Syphilis : Firm, painless, non-itchy skin ulcer,
Taeniasis : None, weight loss, abdominal pain,
Taeniasis/cysticercosis : 1‚Äì2 cm lumps under the skin,
Tay-Sachs disease : Decreased ability to turn over, sit, or crawl,
Tennis elbow : Painful and tender outer part of the elbow,
Teratoma : Minimal, painless lump,
Tetanus : fever, cramped-up jaw, muscle spasms, headache, seizures, sweating, and trouble swallowing,
Thalassaemia : Feeling tired, pale skin, enlarged spleen, yellowish skin, dark urine,
Tinnitus : Hearing sound when no external sound is present,
Tonsillitis : Sore throat, fever, enlargement of the tonsils, trouble swallowing, large lymph nodes around the neck,
Toxic shock syndrome : Fever, rash, skin peeling, low blood pressure,
Trachoma : Eye pain, blindness,
Trichinosis : diarrhea, abdominal pain, vomiting,
Trichomoniasis : Itching in the genital area, bad smelling thin vaginal discharge, burning with urination, pain with sex,
Trisomy : Tall stature, skeletal anomalies, minor neurocognitive and behavioural difficulties,
Tuberculosis : Chronic cough, fever, cough with bloody mucus, weight loss,
Tularemia : Fever, skin ulcer, large lymph nodes,
Turners Syndrome : Webbed neck, short stature, swollen hands and feet,
Typhoid / Enteric Fever : Fever that starts low and increases daily, possibly reaching as high as 1049 ¬∞F (405 ¬∞C) Headache, weakness and fatigue, muscle aches, sweating, dry cough, loss of appetite, weight loss, stomach pain, diarrhea or constipation, rash, swollen stomach (enlarged liver or spleen),
Ulcers : Abdominal pain, vomiting, nausea,
Uremia : Early: Bloody diarrhea, vomiting, fever Later: Low platelets, low red blood cells, kidney failure,
Urticaria : Red, raised, itchy bumps,
Varicose Veins : None, fullness, pain in the area,
Vasovagal syncope : Loss of consciousness before which there may be sweating, decreased ability to see, ringing in the ears,
Viral fever : shivering, feeling cold, chills,
Vitamin B12 Deficiency : Decreased ability to think, feeling tired, anemia, abnormal sensations, depression, irritability, changes in reflexes,
Vitiligo : Patches of white skin,
Warts : Painless, small, rough skin growth,
West Nile fever : None, fever, headache, vomiting or diarrhea and muscle aches rash,
Xerophthalmia : Night blindness,
Yaws : Hard swelling of the skin, ulcer, joint and bone pain,
Yellow Fever : Fever, chills, muscle pain, headache, yellow skin,
Zika virus disease : Fever, red eyes, joint pain, headache, maculopapular rash, Sometimes none,
lactose intolerance : Abdominal pain, bloating, diarrhea, flatulence, nausea,